0 0 0 0 0 0 0 0 0 0 0 0 0 0 0 0 0 0 0 0
2 2 2 2 2 2 2 2 2 2 2 2 2 2 2 2 2 2 2 2
1 0 0 0 0 0 0 0 0 0 0 0 0 0 0 0 0 0 0 0
1 0 0 4 2 5 0 4 2 5 0 4 2 2 2 2 5 0 0 0
1 0 0 1 0 1 0 1 0 1 0 1 0 0 0 0 1 0 0 0
1 0 0 1 0 0 0 1 0 1 0 3 2 5 0 0 1 0 0 0
1 0 0 3 5 0 4 6 0 1 0 0 0 1 0 0 1 0 0 0
1 0 0 0 1 0 1 0 0 1 0 0 0 1 0 4 6 0 0 0
1 0 0 0 1 0 1 0 0 1 0 4 2 6 0 1 0 0 0 0
1 0 0 0 3 2 6 0 4 6 0 1 0 0 0 1 0 0 0 0
1 0 0 0 0 0 0 0 1 0 0 1 0 0 0 1 0 0 0 0
1 0 0 0 0 0 0 4 6 0 0 1 0 4 2 6 0 0 0 0
3 2 2 2 5 0 0 1 0 0 0 1 0 1 0 0 0 0 0 0
0 0 0 0 1 0 0 1 0 0 0 1 0 1 0 0 0 0 0 0
0 0 0 0 1 0 0 3 2 2 2 6 0 3 2 2 2 9 0 0
0 0 0 0 1 0 0 0 0 0 0 0 0 0 0 0 0 1 0 0
0 0 0 0 3 2 2 2 2 2 2 2 2 2 2 2 2 6 0 0
0 0 0 0 0 0 0 0 0 0 0 0 0 0 0 0 0 0 0 0
0 0 0 0 0 0 0 0 0 0 0 0 0 0 0 0 0 0 0 0
0 0 0 0 0 0 0 0 0 0 0 0 0 0 0 0 0 0 0 0